$$$$$$$$$$$$$$$$$$$$$$$$$$$$$$
$           /      __   /    $
$          /      |__| /     $
$---------/           /      $
$                            $
$                            $
$---------\        __ \      $
$          \      |__| \     $
$           \           \    $
$$$$$$$$$$$$$$$$$$$$$$$$$$$$$$